w w w w w w w w
w w w f f f f w
w w w b b b f w
w p f b F F f w
w f b F F F w w
w w w w f f w w
w w w w w w w w 