w w w w w w w w w
w f f f f f f f w
w b b b f b b b w
w F F F F F F F w
w F F F w F F F w
w b b b b b b b w
w p f f f f f f w
w w w w w w w w w