w w f p w w
w w b b f f
w w f b F f
F F F f w w
w w b f w w
w w f f w w 