w w w w f w w w w w
w w w w F w w w w w
w w w w f w w w w w
w w w w b f b F w w 
w w F f b p w w w w 
w w w w w b w w w w 
w w w w w F w w w w 
w w w w w w w w w w 
w w w w w w w w w w 
w w w w w w w w w w