w w w w w w w w
w f f F F b f w
w p b f f b f w
w f b F F f f w
w w w w w w w w