w w w w w w w w
w w F f F F w w
w w F f b F w w
w w w f f b w w
w f b f f b f w
w f w b w w f w
w f f f p f f w
w w w w w w w w