w w w w w w w w
w w f f f f f w
w w f F b F f w
w p f b f b f w
w f f F b F f w
w w f f f f f w
w w w w w w w w